#################################################
#                                               #
#                                               #
#                                               #
#    P                                          #
#                                               #
#                                               #
#                                               #
#                                               #
#                                               #
#                                               #
#                                               #
#                                               #
#                                               #
#                                               #
#                                               #
#                                               #
#                                               #
#                                               #
#                                               #
#                                               #
#                                               #
#                                               #
#                                               #
#                                               #
#                                               #
#                                         T     #
#                                               #
#                                               #
#                                               #
#                                               #
#                                               #
#################################################