#################################################
#                                               #
#                                               #
#                                               #
#                                               #
#                                               #
#     P                                         #
#                                               #
#                                               #
#                                               #
#                                               #
#                                               #
#         #             #            #          #
#         #             #            #          #
#         #             #            #          #
#         #             #            #          #
#         #             #            #          #
#         #             #            #          #
#         ############################          #
#               #               #               #
#               #               #               #
#               #               #               #
#               #               #               #
#               #               #               #
#                                               #
#                                               #
#                                         T     #
#                                               #
#                                               #
#                                               #
#                                               #
#                                               #
#################################################